111111
121001
120001
100001
100001
111111
3,2
2,2;2,3

