1111111111
1100111111
1100100011
1100101211
1100000011
1120100011
1110000211
1101000211
1111111111
1111111111
5,7
2,2;3,5;4,4;7,6

