11111111
11100001
12000011
11100211
12110011
10102011
10020021
10002001
11111111
2,2
2,3;3,4;4,4;6,1;6,3;6,4;6,5