1111111
1120211
1200021
1000001
1200021
1120211
1111111
3,3
2,2;2,3;2,4;3,2;3,4;4,2;4,3;4,4