1111111111
1000000001
1002002001
1000000001
1002002001
1000000001
1111111111
4,3
2,3;2,5;3,3;3,5

BEST_SCORE:17
