11111111
11001001
11001001
11002221
10001001
10001001
11001111
11001111
11111111
3,6
2,5;3,5;4,5
